$$$ exec p1 : [resources/players/vgryshch.filler]
Plateau 100 99:
    012345678901234567890123456789012345678901234567890123456789012345678901234567890123456789012345678
000 XX.XXXXX.XXXXXXXXXXXX..X.XXXXX...XX................................................................
001 XXXXXXXXXXXX.XXXXXXXXXXXXXXXXXX..XX.X..............................................................
002 XXXXX...XXXXXXXXXXX.XXXXXXXX.XX.XXXXX........O.....................................................
003 .XXXXXXXXXX..XX.X.XXXXXXX.XX.XXXXX.XXXX.O..OOO....OO...............................................
004 XXXXXXXXXXXXXXXXX.XXXXX.XXXXXXXXXXOX.OO.O...OO...OOO...............................................
005 XXXXXXXXXXXXXXXXX.X.XXXXXXXXXXXOOXO.OOOOOOOOOO.OOO.O...............................................
006 .XXXXXXXXXX.XXXXX.X.XXXXXX.XXXX.OOOOO.OOOOOO...O...OO..............................................
007 ..XXXXX.X.XXXXX...XXXX.XX.XXX.X.O.OOO..OOO.....O....OO.............................................
008 .XXXXXXXX.XXXXXXXXXX.X..XX.XXO.OO.O.O.OOOOO.O.OO....O..............................OO..............
009 XXX.XXXXXXXXXXXXXXXXXX.....XXOOOO..OOOO..OOOOOO.....................................O..............
010 .XXX.XXXXXXXXXXXX.XXXXXXXXXXXOOOOOOOO.O.OO.OOO............................OO.....OOOOO.............
011 ....XXXXXXXX.XXXX.XXXXX.XXX..X...OOO..O......O............................OOO....O.OOO.............
012 ....XXXXX.X.XXXX..XX.XXXXXX.OX..OOOO..O......OO...........................OO....OO.................
013 ....XX.XXXXXXXXX.XXXXXX.XXX.OOOOOOOO....OOO..OOOOOO.......................OOOOOOOO.................
014 .......XX..XXXXO..XXXXXX..X.O......O....OOO.....OOO.....................OOOOO.O.OO.................
015 .OO.....X......O..XXXXXX..X.....OOOO...OOO.......OO..................OOOOO......O..................
016 ..OO....X.OOOOOO...XX.XXX.XXXX..OOOO...OO............................OO.........OOOO...............
017 .OOOO...O..O..OO...XOO....X.XXX..OOOO.OOOO............................O............OO..............
018 OOOOO.O.O.OOOO.O.OOOOOOOO.XXXXXX...O...OO........................O....O............................
019 .OOOOOOOOOOOOO.OOO...OOOO..XXXX....O...OO..................O.....OOOOOO............................
020 .OO.OO....OO.OOO.....OOOO..XX.XX...OOOOO...................O.....OO................................
021 .O.........O.....OO..O..O.X.XXXXX.OOOOOO.................OOO......O................................
022 .OO........O....OOOO.OO.OXX..XXXX.O..OOO................OOOO......OO...............................
023 ..OO.......O.....OOOOOOOO..OO...X...OOOOOO...............OO......OOO...............................
024 ..OOO......O.......OOOOO..OOO..XX...O..OO................OO......O.................................
025 ...O......OO.......OO..OO.OO....X...O....................O......OOO................................
026 .OO.......OO............OOO.....X..OOO...................OOO....O.O................................
027 ..........OO.............OO....XXX..OOOOO...............OOOOO.....O................................
028 .........OO..............O...XXXXO.....OO...............O...O.....OO...............................
029 .........O..............OO...XX..OO....O....................OOOOOOO................................
030 ........OO..............OO....OOOO..OOOO...........O.......OOO...OO................................
031 ........OO........OOOO...OOO.OOOOOOOOO.....OOO....OO.....O..O...OO.................................
032 ........O...........OO.OOO.OOO.OOOO..OO....O.O.....OOO...O.......OO................................
033 ........OO.O.........OO......OOO.....OOO...O.O.....OOOOOOO.......OOO...............................
034 ........OOOO...............O.OO......OOOO..O.......OO.OO..........OO...............................
035 .........O......O..........OOO.......O..OO.OO.OOO...O...O.......OOO................................
036 ........OO......OOO........OO........O...OOO..OOO......OO.........O................................
037 .................OOO.OO.....O........O.....OOOOO.......O..........O................................
038 .................OOOOO......O......OOO.....O..OO.......OOO.......OO................................
039 .................O.OOOO....OO......OOO.....O....OO.OO..O.........O.................................
040 ....................OOOO..O......OOO.....O.......OOOOOOO.........OO................................
041 .......................OOOO......O.......OO.......O.OO............OO...............................
042 ........................OO.......OO......OOOOOO..OO..O..........OOOO...............................
043 ........................O........OO.......OOOOO.OO...O........OOOO.................................
044 ........................O....................OO.O....OOO......O....................................
045 ........................O....................OOO.......O......OOO..................................
046 ........................OO.....................O....O.OO........OO.................................
047 .........................O...................OOO...OOOO..........OO.O..............................
048 .......................OOO...................OO.......O..........O..O.o............................
049 .......................O.....................OOO......O..........OOOOo.............................
050 .............O........OO..............................O.........OOOO.O.............................
051 ............OO.O......OO..............................OO.........OO..OOOO..........................
052 ..........O.OOOO.OO..OOOOO.............................OOOOO.....O...O.OO..........................
053 ..........OO.OOO.OOOOO.OO................................OOO....OO......O..........................
054 ..............OOO....OO...................................OO.....O.................................
055 ..............OO.....OO...................................OO.OO.OO.................................
056 ..............OO.....O.....................................OOOO.OO...O.............................
057 ...............O...........................................OOOOOOOO..OO............................
058 ................OO.............................................O.OOO..O............................
059 .................................................................OOOOOO............................
060 ...................................................................OO.O............................
061 ..................................................................OOO..............................
062 ..................................................................OO...............................
063 ..............................................................O...OO...............................
064 ..............................................................O.O.OOO..............................
065 ..............................................................O.OOOOO..............................
066 ..........................................................O...OOOOO.O..............................
067 .........................................................OOOO..OO.OO...............................
068 ..........................................................OOOOOO...OO..............................
069 ........................................................OOOO.....OO.OOO............................
070 ...................................................................O.OO............................
071 ..................................................................OO...............................
072 ..................................................................OO...............................
073 ...................................................................O...............................
074 ...................................................................................................
075 ...................................................................................................
076 ...................................................................................................
077 ...................................................................................................
078 ...................................................................................................
079 ...................................................................................................
080 ...................................................................................................
081 ...................................................................................................
082 ...................................................................................................
083 ...................................................................................................
084 ...................................................................................................
085 ...................................................................................................
086 ...................................................................................................
087 ...................................................................................................
088 ...................................................................................................
089 ...................................................................................................
090 ...................................................................................................
091 ...................................................................................................
092 ...................................................................................................
093 ...................................................................................................
094 ...................................................................................................
095 ...................................................................................................
096 ...................................................................................................
097 ...................................................................................................
098 ...................................................................................................
099 ...................................................................................................
Piece 18 16:
................
................
................
................
................
................
................
................
................
................
................
.........**.....
........****....
.......****.....
.........**.....
.........*......
................
................
