$$$ exec p2 : [resources/players/vgryshch.filler]
Plateau 24 40:
    0123456789012345678901234567890123456789
000 XOOOOOOOOOOOOOOOOOOOOOOOOO.ooooo.OOO....
001 XOOOOOOOOOOOOOOOOOOO.O......OOOO.O.O..OO
002 XXOOOOOOOOOOOOOOO.OO.O......O.OOOOOOOOOO
003 XXOOOXXXOOO..OOOOO.O.OOOOO....OOOO.O.OOO
004 XXXXXXXXOOOOOO..OO.OOO.OOO.....O...O..OO
005 XXXXXOOXXOOOOOO.OOOOOOO............OOOOO
006 XXXXXOOOOOOO.OOOOO..O.O........OOO..OOOO
007 XXXXXOXXOOOO.OO..OOOOOO........OOO..OOO.
008 XXXXXXXXXOOOOOOOOOOO..OOOO.......OOOO.OO
009 XXXXXXXXXXXOOOOXOXXOOOOO..........O.OOOO
010 XXXXXXXXXXXXXOXXXXXXOOO.............O...
011 XXXXXXXXXXOOOOXXXXXXOOO...........OO.OOO
012 XXXXXXXXXXXOOXXXXXXXXOOO..OOOOO.O..OOOOO
013 XXXXXXXXXXXXOXXXXXXXXXXOO.OOOO..O..OOOOO
014 XXXXXXXXXXXXOXXXXXXXXXXOOOOOOOOOO...OOO.
015 XXXXXXXXXXXXXXXXXXXXXXXXOOOXXXXXOO.OOOOO
016 XXXXXXXXXXXXXXXXXXXXXXXXXOOXXXXXOOOO..OO
017 XXXXXXXXXXXXXXXXXXXXXXXXXXXXXXXXO...OOOO
018 XXXXXXXXXXXXXXXXXXXXXXXXXXXXXXXXXOOOOOOO
019 XXXXXXXXXXXXXXXXXXXXXXXXOOOXXXXXXXOO.OOO
020 XXXXXXXXXXXXXXXXXXXXXX.XOOOOOOXXXXOOOOOO
021 XXXX.XXXXXXXXXXXXXX.XXX.OO.OOOOOOOOOOOOO
022 XXXXXXXXXXX.XXX..............OOOOOOOOO.O
023 XX...X.....XXX..............OOOOOOOOOOOO
Piece 4 3:
..*
***
.**
***
