$$$ exec p1 : [resources/players/vgryshch.filler]
Plateau 15 17:
    01234567890123456
000 XXXXXXXXXXXXXXXXX
001 XXXXXXXXXXXXXXXXX
002 XXXXXXXXXXXXXXXXX
003 XXXXXXXXOOOXXXXXX
004 XXXXXXXXOOOOOXXXX
005 XXXXXOXXXXXOXXXXX
006 XXXXOOOXXXXOXXXXX
007 XXXXXXOXXXXOOOOXX
008 xXOOOOOOOOOOOOOOX
009 x.O...OXXXXXXXXXX
010 ......OOOOOXXXXXX
011 ......O...OO.XXXX
012 ....OOOOOOOOOXXX.
013 ......OOO.O.XXXX.
014 .......OOO.......
Piece 1 3:
***
